2 13 31
###############################
#      ** *    *   *          #
# # # #*# # #*#*# # # #*#*#*# #
#   *    f***  *  2   * *** * #
# # # # # #*# # # # # # #*# # #
#         **x** 1*  *    *    #
# # # # # # # # # #*# #*# # # #
#*  *    *    x  2   *        #
# # # # #*# # # #*#*# # # # # #
#*    **  *       *     2    f#
# #x# # # # # # #*# # # # # # #
#  *        *   *  *   1     p#
###############################