2 13 31
###############################
#      ** *    *   *    5     #
# # # #*# # #*#*# # # #*#*#*# #
#   *    f***  *  2   * *** * #
# # # # # #*# # # # # # #*# # #
#   4     **x** 1*  *  3 *    #
# # # # # # # # # #*# #*# # # #
#*  *    *    x  2   *  bs    #
# # # # #*# # # #*#*# # # # # #
#*    **  *       *     2    f#
# #x# # # # # # #*# # # # # # #
#  *   6    *   *  *   1     p#
###############################