2 13 31
###############################
#      ** *    *   *          #
# # # #*# # #*#*# # # #*#*#*# #
#   *    f***  *  2   * *** * #
# # # # # #*# # # # # # #*# # #
#         **p** 1*  *    *    #
# # # # # # # # # #*# #*# # # #
#*  *    *    *  2   *        #
# # # # #*# # # #*#*# # # # # #
#*    **  *       *     2     #
# #p# # # # # # #*# # # # # # #
#  *        *   *  *   1     p#
###############################