2 13 31
###############################
#    3                     **x#
#    2                     ***#
#          #*****#         ***#
#    3     #  4  #        1   #
#          # *** #            #
#          # *** #            #
#    1     # *** #        3   #
#          #  4  #            #
#    4     #*****#         ***#
#    4         p           ***#
#    2                     ***#
###############################