2 13 31
###############################
#p *        *1   1            #
# # # # # # # # # # # #*#*#*# #
#   ******        1   * 1 * * #
# # # # # #*# # #*#*# # # # #*#
#    2 2     **  *  *   1     #
# # # # # # # # # #*# #*# # # #
#*  *      *  *   2  *   1    #
# # # # #*# # # #*#*# # # # # #
#*    **  *       * 2   2f2   #
# #*# # # # # # #*# # # # # # #
#      2    *   * x*      2   #
###############################