2 13 31
###############################
#*   3                     **x#
#    2                 4   ***#
#          #     #         ***#
#    1     #     #        1   #
#          #     #            #
#          # *p  #            #
#    1     #     #        1   #
#          #  1  #            #
#          #     #         ***#
#    3                     ***#
#*   5                     ***#
###############################