2 13 31
###############################
#p *        *    1   *   *    #
# # # # # #*# #*# # # #*#*#*# #
#*  ** ***        3   * 1 * * #
# # # # # #*# # #*#*# # # # #*#
#    2       **  *  *   1     #
# # # # # # # # # #*# #*# # # #
#*  *      *  *   2  *   1    #
# # # # #*# # # #*#*# # # # # #
#*    **  *       * 2   3f    #
# #*# # # # # # #*# # # # # # #
#      2    *   * x*      3   #
###############################