2 13 31
###############################
#      ** *    *   *    5    x#
# # s #*# # #*#*# #*# #*#*#*# #
#   *    f***  *  2*# * *b* * #
# # #*****#*# # # **# # #*# # #
#   4   p ** ** 1*f*#  3 *    #
# # **    # # # # #*# #*# # # #
#*  ******  # x  2   *        #
# # # # #*### # #*#*# # # # # #
#*    **  #       *     2    f#
#  3  # # # # # #*#*# #       #
#x      6    *   ****   1    x#
###############################