2 13 31
###############################
#    3                     **x#
#    2                     ***#
#          #*****#         ***#
#    1     #  4  #        1   #
#          # *** #            #
#          # *p* #            #
#    1     # *** #        1   #
#          #  4  #            #
#          #*****#         ***#
#    3                     ***#
#    2                     ***#
###############################