2 13 31
###############################
#    3                     **x#
#    2                     ***#
#          #****b#         ***#
#    2     #  4  #        1   #
#          # *** #            #
#          # *** #            #
#    1     # *** #        3   #
#          #  4  #            #
#    4     #*s***#   *********#
#    4               *     *f*#
#                4   *    p***#
###############################