2 13 31
###############################
#    3                     **x#
#    2                     ***#
#          #****b#         ***#
#    3     #  4  #        1   #
#          # *** #            #
#          # *** #            #
#    1     # *** #        3   #
#          #  4  #            #
#    4     #*s***#   * 2   ***#
#    4         p     *     *f*#
#                4   *     ***#
###############################